1111111111111111111111
1000000000000000000001
1000e00000000000000e01
1000000000000000000001
1000000000000000000001
10000e0000c00000000001
1000000000000000000001
1000000000000000000001
10000000000000000000d1
1111111111111111111111